NO assets/textures/greystone.xpm
SO assets/textures/bricksx64.xpm
WE assets/textures/test.xpm
EA assets/textures/lava.xpm  

F 220,100,0
C 225,30,0

11111
10001
10101
100N1
11111