NO assets/textures/greystone.xpm
SO assets/textures/bricksx64.xpm
WE assets/textures/test.xpm
EA assets/textures/lava.xpm       

C 135,252,250
F 34,159,34

111111111111111111
100000000000000001
100001000000010001
100000000000000001
10000N000000000001
100000000000011001
100000000000000001
111111000000000001
111111111111111111